Case-Fun (O),Case-Syn (O),Control-Fun (O),Control-Syn (O),Control-Fun (E),Control-Syn (E),Control-Fun (O-E),Control-Syn (O-E),Ratio-Case,Ratio-Control,P-Value
664,303,1383,636,1328,606,55,30,2.19141914191419,2.17452830188679,0.926831154876113
598,309,1205,585,1196,618,9,-33,1.93527508090615,2.05982905982906,0.470301041070123
545,332,1153,663,1090,664,63,-1,1.64156626506024,1.73906485671192,0.497542749978193
609,264,1099,628,1218,528,-119,100,2.30681818181818,1.75,0.00179331833011493
583,287,1179,631,1166,574,13,57,2.03135888501742,1.86846275752773,0.337848160006671
608,313,1190,646,1216,626,-26,20,1.94249201277955,1.84210526315789,0.53214232076544
577,336,1231,686,1154,672,77,14,1.7172619047619,1.79446064139942,0.598885808534599
640,276,1276,649,1280,552,-4,97,2.31884057971015,1.96610169491525,0.0558773337979348
633,301,1262,687,1266,602,-4,85,2.10299003322259,1.83697234352256,0.10868469898728
596,302,1244,625,1192,604,52,21,1.97350993377483,1.9904,0.921061323778056
589,352,1185,613,1178,704,7,-91,1.67329545454545,1.93311582381729,0.0853484578611078
556,315,1273,588,1112,630,161,-42,1.76507936507937,2.16496598639456,0.0184221208585387
593,288,1244,622,1186,576,58,46,2.05902777777778,2,0.737995793898702
592,328,1173,694,1184,656,-11,38,1.80487804878049,1.69020172910663,0.433209329071606
581,324,1187,658,1162,648,25,10,1.79320987654321,1.80395136778116,0.943776155627368
654,294,1221,613,1308,588,-87,25,2.22448979591837,1.99184339314845,0.197450242128914
609,287,1202,610,1218,574,-16,36,2.1219512195122,1.97049180327869,0.394829158301851
618,335,1258,675,1236,670,22,5,1.84477611940299,1.8637037037037,0.902068424981406
645,334,1181,657,1290,668,-109,-11,1.9311377245509,1.79756468797565,0.388085432341298
606,310,1241,591,1212,620,29,-29,1.95483870967742,2.09983079526227,0.40530554219851
567,288,1096,636,1134,576,-38,60,1.96875,1.72327044025157,0.128622791037225
583,271,1200,669,1166,542,34,127,2.15129151291513,1.79372197309417,0.0378886596037616
584,322,1231,713,1168,644,63,69,1.81366459627329,1.72650771388499,0.556682199637404
594,292,1126,682,1188,584,-62,98,2.03424657534247,1.65102639296188,0.0152334174741453
631,292,1193,590,1262,584,-69,6,2.16095890410959,2.02203389830509,0.443598204429315
620,320,1131,707,1240,640,-109,67,1.9375,1.5997171145686,0.0219117079025776
618,317,1224,642,1236,634,-12,8,1.94952681388013,1.90654205607477,0.791912702333728
510,320,1211,622,1020,640,191,-18,1.59375,1.94694533762058,0.0213224851899894
602,273,1221,562,1204,546,17,16,2.20512820512821,2.17259786476868,0.867348959648483
657,349,1253,666,1314,698,-61,-32,1.88252148997135,1.88138138138138,0.994088973522111
613,249,1164,591,1226,498,-62,93,2.46184738955823,1.96954314720812,0.0131927938297047
624,313,1189,625,1248,626,-59,-1,1.99361022364217,1.9024,0.581699885122412
539,312,1108,632,1078,624,30,8,1.7275641025641,1.75316455696203,0.865552860283639
527,365,1175,707,1054,730,121,-23,1.44383561643836,1.66195190947666,0.090851335911542
613,299,1184,678,1226,598,-42,80,2.05016722408027,1.74631268436578,0.059510962118723
562,252,1199,532,1124,504,75,28,2.23015873015873,2.25375939849624,0.908910084681478
553,328,1162,693,1106,656,56,37,1.6859756097561,1.67676767676768,0.948394587141788
605,291,1199,657,1210,582,-11,75,2.07903780068729,1.82496194824962,0.129817057818552
584,324,1227,663,1168,648,59,15,1.80246913580247,1.85067873303167,0.754562597176098
658,335,1240,656,1316,670,-76,-14,1.96417910447761,1.89024390243902,0.642376382096224
630,291,1285,607,1260,582,25,25,2.16494845360825,2.1169686985173,0.795028803581938
633,280,1163,664,1266,560,-103,104,2.26071428571429,1.75150602409639,0.00306310830087187
640,282,1222,672,1280,564,-58,108,2.26950354609929,1.81845238095238,0.00968207881457349
571,318,1302,669,1142,636,160,33,1.79559748427673,1.94618834080718,0.3418575473512
589,260,1102,639,1178,520,-76,119,2.26538461538462,1.7245696400626,0.0021630163019178
517,281,1122,672,1034,562,88,110,1.83985765124555,1.66964285714286,0.272992296888027
531,315,1112,631,1062,630,50,1,1.68571428571429,1.76228209191759,0.609235957291942
586,324,1213,640,1172,648,41,-8,1.80864197530864,1.8953125,0.580954255776855
613,294,1222,596,1226,588,-4,8,2.08503401360544,2.0503355704698,0.846590416669186
582,281,1153,637,1164,562,-11,75,2.0711743772242,1.81004709576138,0.123859359030693
631,371,1215,659,1262,742,-47,-83,1.70080862533693,1.84370257966616,0.321953515786842
572,347,1161,654,1144,694,17,-40,1.64841498559078,1.77522935779817,0.376852773379483
589,315,1182,604,1178,630,4,-26,1.86984126984127,1.95695364238411,0.596196250168006
619,300,1160,706,1238,600,-78,106,2.06333333333333,1.64305949008499,0.00709950111924655
635,318,1227,651,1270,636,-43,15,1.99685534591195,1.88479262672811,0.491705267958896
565,318,1184,604,1130,636,54,-32,1.77672955974843,1.96026490066225,0.254310727436586
614,293,1261,607,1228,586,33,21,2.09556313993174,2.07742998352554,0.919955100798356
602,334,1164,613,1204,668,-40,-55,1.80239520958084,1.89885807504078,0.537693120806357
614,346,1273,661,1228,692,45,-31,1.77456647398844,1.92586989409985,0.322294122516784
582,301,1156,632,1164,602,-8,30,1.93355481727575,1.82911392405063,0.520636014345636
584,312,1288,679,1168,624,120,55,1.87179487179487,1.89690721649485,0.874940688818645
586,313,1206,588,1172,626,34,-38,1.87220447284345,2.05102040816327,0.290677026863472
578,289,1188,618,1156,578,32,40,2,1.92233009708738,0.65039699164843
668,321,1221,597,1336,642,-115,-45,2.0809968847352,2.04522613065327,0.83699151189777
605,358,1260,718,1210,716,50,2,1.68994413407821,1.75487465181059,0.643591209746739
621,361,1204,666,1242,722,-38,-56,1.7202216066482,1.80780780780781,0.544680698458846
550,338,1119,670,1100,676,19,-6,1.62721893491124,1.67014925373134,0.758403458480095
611,341,1216,605,1222,682,-6,-77,1.79178885630499,2.0099173553719,0.171766890082863
635,326,1261,665,1270,652,-9,13,1.9478527607362,1.89624060150376,0.747048498408556
586,330,1221,625,1172,660,49,-35,1.77575757575758,1.9536,0.259867424302075
620,296,1159,646,1240,592,-81,54,2.09459459459459,1.79411764705882,0.0709907556139863
605,296,1216,688,1210,592,6,96,2.04391891891892,1.76744186046512,0.0881012838587212
601,298,1149,650,1202,596,-53,54,2.01677852348993,1.76769230769231,0.125150984846915
598,303,1179,619,1196,606,-17,13,1.97359735973597,1.90468497576737,0.68003092644979
547,362,1210,654,1094,724,116,-70,1.51104972375691,1.85015290519878,0.0153481684027413
622,322,1197,686,1244,644,-47,42,1.93167701863354,1.74489795918367,0.22354202031508
668,333,1231,743,1336,666,-105,77,2.00600600600601,1.65679676985195,0.0186353469112078
630,346,1149,585,1260,692,-111,-107,1.82080924855491,1.96410256410256,0.367649881773108
537,326,1206,577,1074,652,132,-75,1.64723926380368,2.09012131715771,0.00609164356451227
616,342,1205,678,1232,684,-27,-6,1.80116959064327,1.77728613569322,0.871862824545553
568,323,1191,749,1136,646,55,103,1.75851393188855,1.59012016021362,0.22915443364703
629,382,1198,640,1258,764,-60,-124,1.64659685863874,1.871875,0.115109005927031
644,303,1216,540,1288,606,-72,-66,2.12541254125413,2.25185185185185,0.50580268593423
592,308,1205,578,1184,616,21,-38,1.92207792207792,2.08477508650519,0.348639895441064
596,250,1200,559,1192,500,8,59,2.384,2.14669051878354,0.248536749558032
542,334,1154,627,1084,668,70,-41,1.62275449101796,1.84051036682616,0.141197397591993
642,353,1129,687,1284,706,-155,-19,1.81869688385269,1.6433770014556,0.21596292769718
620,366,1298,687,1240,732,58,-45,1.69398907103825,1.88937409024745,0.178758040091246
593,282,1153,621,1186,564,-33,57,2.10283687943262,1.85668276972625,0.155151562857278
616,323,1128,654,1232,646,-104,8,1.90712074303406,1.72477064220184,0.233331108595029
572,343,1197,681,1144,686,53,-5,1.66763848396501,1.75770925110132,0.52887794111159
594,305,1159,614,1188,610,-29,4,1.94754098360656,1.88762214983713,0.717232101816919
601,343,1260,620,1202,686,58,-66,1.75218658892128,2.03225806451613,0.0766552841483123
627,287,1140,582,1254,574,-114,8,2.18466898954704,1.95876288659794,0.211780278213512
589,325,1187,645,1178,650,9,-5,1.81230769230769,1.84031007751938,0.856315718647654
584,337,1157,629,1168,674,-11,-45,1.73293768545994,1.83942766295707,0.480504522634958
544,317,1134,595,1088,634,46,-39,1.71608832807571,1.90588235294118,0.22818894705593
577,292,1218,613,1154,584,64,29,1.97602739726027,1.98694942903752,0.949624132889607
617,337,1177,646,1234,674,-57,-28,1.83086053412463,1.82198142414861,0.953613487162535
603,346,1217,697,1206,692,11,5,1.74277456647399,1.74605451936872,0.981815755652322
